NO ./path_to_the_north_texture
NO ./path_to_the_north_texture
WE ./path_to_the_west_texture
EA ./path_to_the_east_texture
   
F 220,100,0
C 225,30,9

11111111
11N1
11111111
