
NO ./path_to_the_north_texture
WE ./path_to_the_west_texture
EA ./path_to_the_east_texture
SO ./path_to_the_south_texture



F 2,100,255
C 225,30,20






 1111111        1111111111111111111111111111111111111111
110000011      10000000001
100000001     1000000000001
 1000001     100000000000001
  11011      1000000000000001
   101        10000001100000011
   101         1000011 100000001
   1011111111111000001100000011
   10000000000000000000000001
   1011111111111000000000001
   101         100010000001
   101        10001110000111111
  11011      100000N00001100000111111
 1000001     1000000000011111111111111
100000001     10000000001
110000011      1000000001
 1111111    1   111111111111111111111111111
 1111111   101   111111111111111111111111101
            1                             1
